...............
...............
...............
...............
......PP.......
..PP......PP...
..............F
PPPPPPPPPPPPPPP