...............
...............
......PP.......
..PP...........
......PP.......
..PP...........
..............F
PPPPPPPPPPPPPPP