...............
...............
...............
...............
...............
....PP.........
..............F
PPPPPPPPPPPPPPP